....##.#.#...#.##.##..#.#..#.....#..#....#..#.....
#.#..#.#.###....#..##...#.##.#.####...#####...#.##
####.#.#.#...#.###....###....###..##.##.##..#####.
.#.......#.#####.#.####.#.####.##.......#..###.#..
...##.##...#.......#..#.#.#.#...####.#####.##....#
.####.####...#.#####.##.#.#.#.###.......#.....#.##
##..#.#....#####.#.#..#...#...#.####.####.#######.
.##.#.####..#.#..#...##.###.###.##...#.##.##.#.##.
.##.#.#.#..##.#.##.####.##...##..###.#.#...#....#.
....###.##..#.#..#.#.#...#.###..##.#.#.##.##.####.
###..##.###.#.#.##...#.#.#...##..#.#............#.
....##..#.#.#.#..#.#.#.###.#.#..##.#.###.#.###.##.
###.###.......#.##.###.#.#.####......#.#####.###..
#.#.#.##.####....#..#......#.#####.###..#..#.#...#
..#.#..###....####.##.######..##.#.#.#.##.##.###..
#.#.#.##.####.#..#....#.#....##....#.#.....#.#.#.#
....#..#.##.#.##.#.####.#.#######.##...##.##.#.#..
###...##..#......#...##.#..#..#....###..####.#...#
....#..##.####.###.###....##.####.###..##......###
######..#.#.##.#.#.#.#.#####.##.#...##..####.###..
#.#.#..##.#.#........#.#......#...#####...##.#.#.#
..#.##.##...#.#.######...######.####..#.###.......
#.#..#..###...#..##.#..###..#.#.#..##.#.#...######
#.#.##.##.###.####..#.##.#.##.#.#.##..#.##.##.....
....#...#.#...#..##.#..#....#.#.#..##.......##.###
##.###.##.#.####.#....##.####.#.#.######.####...#.
.#..#...#.#..##..#.####...#.#......#..#.......#...
.#.##.###.##..##....#.##.##.#.#######...#.##.#####
.#.#..#.#.###..##.###.......#..##..####.###.......
.#...##.#..##.##......#.#.###.##..##.#...#########
...###....##...#.###########...##.##.##.##........
##...##.####.###.#.#.....#.###..#.#...#....####.#.
.#.###...#.#.........##.##.##..##...###.##....###.
.#.#.##.##...############..#..##..#......######.##
...#.#...#.###.#....#..##.###....##.##.###.#.....#
.###.#.###.#.#.#.####.##..#.#.#####.#........###..
.#......#.........#....##.#.#.#.#.####.#.#.#...###
...#.#####.########.####...........#.############.
.#.####........#.##.#.###.#######.##..#....#......
##..#.##.#######.#..#.#.#.......#.###...####.####.
.##...#.....##.#.##.#.....#########.###...#.....#.
.##.###.###..#........#####....#.##.#.#.###.#####.
..........######.###.##.....####.#..............#.
###.#######.##.#..#.....##.##.##.#.##########.####
......#..##......####.###..##.#..........##.###...
#####...##..##.#....#...##......#.#.##.#..#.....#.
.#.##.###..##..#.####.#.#..#.##.#########...##.###
....#.....######...######.##..#.........#.#..#....
###.#.#####.#.##.###....#.##.####.#.#.###.##.#.###
...............#.....#.##..#....#.#.#...#..#.#....
